+-+-+-+-+-+-+-+
      |       |
+ +-+-+ +-+-+ +
| |         | |
+ + +-+-+-+-+ +
|   |         |
+-+-+ +-+-+-+-+
|   |   |     |
+ +-+-+ + +-+ +
|   |   |   | |
+-+ + +-+-+ + +
|     |     | |
+ +-+-+ +-+-+ +
|     | |     |
+-+-+ + + +-+-+
|   |   | |   |
+ + +-+-+ + + +
| |       | | |
+ +-+-+-+-+-+ +
|              
+-+-+-+-+-+-+-+