+-+-+-+-+-+-+-+-+-+-+
    |   |   |   |   |
+-+ + + + + + + + + +
| |   | | | | |   | |
+ + +-+ +-+ + +-+-+-+
|   |     |     |   |
+ +-+-+ + +-+ +-+ + +
|   |   |     |   | |
+-+ + +-+-+-+-+ +-+ +
| | |   |     | |   |
+ + +-+ + +-+-+ + +-+
|   | | |   |   |   |
+-+-+ + +-+ + +-+-+ +
|   |         |     |
+ + +-+-+-+-+-+ +-+-+
| | |         | |   |
+ +-+ +-+-+-+ + + + +
| |   |     |     | |
+ + + + +-+-+-+ +-+ +
|   | |         |    
+-+-+-+-+-+-+-+-+-+-+
