+-+-+-+-+-+-+-+-+-+-+-+-+-+-+-+
        |     |     |       | |
+-+-+-+ + +-+ + +-+ + +-+-+ + +
|   |   |   | |   | | |   | | |
+ + + +-+-+-+ +-+ + + + + + + +
| |       |     | |   | |   | |
+ +-+-+-+ + + +-+ +-+-+ +-+-+ +
|   |     | |       |   |     |
+-+ + +-+-+ +-+-+ + + +-+ + +-+
|   |       |     | |     |    
+-+-+-+-+-+-+-+-+-+-+-+-+-+-+-+