+-+-+-+-+-+-+-+-+-+-+-+-+-+-+
  |       |     |   |     | |
+ + +-+-+ + + + + + +-+-+ + +
|   | |     | |   |       | |
+-+-+ + + +-+-+ +-+-+-+-+-+ +
|       |     | |     |     |
+ +-+-+-+-+-+ + + +-+ + +-+-+
|     |       |   | |   |   |
+-+-+ + +-+-+-+-+-+ + +-+ + +
|   | |         |   |     | |
+ +-+ +-+ + +-+-+ +-+-+-+-+ +
|     |   | |           |   |
+-+-+-+ +-+ + +-+-+-+ +-+ +-+
|       |   |       |        
+-+-+-+-+-+-+-+-+-+-+-+-+-+-+